x  p  p  p  x  x  x  x  x  x  x  x  p  p  p
x  p  S1 p  x  x  x  x  x  x  x  x  p  W1 p
x  p  p2 p  x  x  x  p  p  p  p1 p1 p  p  p
x3 p  p  p  x4 x  x  p  e  p  x  x  p  p  W2
p  x  x  x  p  x  x  p  p  p  x  x  x  x  p1
W3 x  x  x  p  x  x  w  w  w  x  x  x  x  p
p  x2 x2 p  p  p  w  w  w  w  w  p  p  p  p
x  x  x  p  s  p  w  w  w  w  w  p  t1 p  x
x  x  x  p  p  p  w  w  w  w  w  p  p  p  x
x  x  x  p  p  p  p  p  x1 x  x  x  x  x  x
--------
W2 closes p1
W1 toggles x1
W1 opens x2 
t1 teleports t1, p2
W3 opens x3
W3 closes x2
S1 opens x4