x x x x x 
x p s p x 
x p p p x 
x p p e x 
x x x x x 
